###################
#                 #
#    $  $         #
#                 #
#    $ $          #
#                 #
#           @   ..#
# $  $          ..#
#               ..#
###################
              
